0,0,0,12,1,0,2,3,0,0,0,
0,20,20,13,0,20,15,0,20,20,0,
0,8,20,20,20,20,20,20,20,0,0,
0,0,1,0,3,1,0,12,0,0,0,
13,0,11,20,0,20,20,20,0,9,0,
15,0,0,20,20,20,7,20,11,0,14,
0,9,0,2,0,0,1,1,0,0,13,
0,12,20,20,20,20,20,20,0,0,0,
0,20,20,8,20,0,13,20,15,0,0,
0,20,0,0,2,0,0,20,20,20,0,
0,0,0,2,17,12,0,2,0,0,0,
,
,
,
,
,
,
,
,
,
,
,
,
,
,
,
,
,
,
,
,
,
,
,
,
,
,
,
,
,
,
,
,
,
,
,
,
,
,
,
,
,
,
,
,
,
,
,
,
,
,
,
,
,
,
,
,
,
,
,
,
,
,
,
,
,
,
,
,
,
,
,
,
,
,
,
,
,
,
,
,
,
,
,
,
,
,
,
,
,
